NO ./textures/purplestone.xpm       F    255,128,111 




SO ./textures/mossy.xpm        WE               ./textures/redbrick.xpm 



         EA    ./textures/wood.xpm              C 42,82,190        




11111111
100000001
100S000001
10000000001
100000000001
100000000001
100000000001
1000000000001111
1000000000000001
1000000000000001
1001111000111111
1001   10001
1001    10001
1001     10001
1111      11111



