NO ./textures/purplestone.xpm       F    255,128,111 




SO ./textures/mossy.xpm        WE               ./textures/redbrick.xpm 



         EA    ./textures/wood.xpm              C 42,82,190        




         111111111
        10000000001
       1000000000001
      100000000000001
      100000000000001
      100000000000001
 1111100000000000000011111
 100000000000E000000000001
 1111100000000000000011111
     10000000000000001
    1000111100011110001
   10001   10001   10001
  10001    10001    10001
 10001     10001     10001
11111      11111      11111



