NO ./textures/purplestone.xpm       F    255,128,111 




SO ./textures/mossy.xpm        WE               ./textures/redbrick.xpm 



         EA    ./textures/wood.xpm              C 42,82,190        




   11111     11111
 110000011 110000011
100000000010000000001
100001100000001100N01
100001100000001100001
100000000010000000001
 110000011 110000011
   11111     11111


