NO ./textures/purplestone.xpm       F    255,128,111 




SO ./textures/mossy.xpm        WE               ./textures/redbrick.xpm 



         EA    ./textures/wood.xpm              C 42,82,190        



11111111111111111111111111111111111111111111111111111111111111111111111111111111111111111111111111111111111111111111
1E000011100D0011100D0011100D0011100D0011100D0011100D0011100000111000001110000011100000111000001110000011100000110001
1111100D0011100D0011100D0011100D0011100D0011100D00111000001110000011100000111000001110000011100000111000001110000001
11111111111111111111111111111111111111111111111111111111111111111111111111111111111111111111111111111111111111110001
11111111111111111111111111111111111111111111111111111111111111111111111111111111111111111111111111111111111111111111