NO ./textures/purplestone.xpm       F    355,128,111 




SO ./textures/mossy.xpm        WE               ./textures/redbrick.xpm 



         EA    ./textures/wood.xpm              C 42,82,190        




1111
1001
1111
     11111111111
1111100100N00001
1000001 10001111
100000111001
111111111011
1000A0000001
11111000000011111
    1000000000001
    1000000000111
 11111111111111






