NO ./textures/greystone.xpm
WE ./textures/greystone.xpm
EA ./textures/greystone.xpm

C 255,0,255
F 0,255,255

NO ./textures/greystone.xpm

111111111111
100000000001
100000000001
10000E000001
100000000001
100000000001
100000000001
111111111111
