NO ./textures/greystone.xpm
C 255,255,255
SO ./textures/greystone.xpm
WE ./textures/greystone.xpm
EA ./textures/greystone.xpm

F 255,255,255

111111011111
100000000001
100000000001
10000E000001
100000000001
100000000001
100000000001
111111111111
